R 640 480
NO ../textures/wall_no.xpm
SO ../textures/wall_so.xpm
WE ../textures/wall_we.xpm
EA ../textures/wall_ea.xpm
S ../textures/barrel.xpm
F 255,195,0
C 225,30,0

        1111111111111111111111111
        1000000000110000000000001
        1011000001110000002000001
        1001000000000000000000001
111111111011000001110000000000001
100000000011000001110111111111111
11110111111111011100000000001
11110111111111011101010000201
11000000110101011100000010001
10002000000000000000000010001
100000000000000011010100100011
11000001110101011111011110N0011
11110111 1110101 1011110100011
11111111 1111111 111111111111
