R 1280 960
NO ../textures/wall.xpm
SO ../path_to_the_south_texture
WE ../path_to_the_west_texture
EA ../path_to_the_east_texture
S ../textures/barrel.xpm
F 255,195,0
C 225,30,0

        1111111111111111111111111
        1000000000110000000000001
        1011000001110000002000001
        1001000000000000000000001
111111111011000001110000000000001
100000000011000001110111111111111
11110111111111011100000000001
11110111111111011101010000001
11000000110101011100000010001
10002000000000000000000010001
100000000000000011010100100011
11000001110101011111011110W0011
11110111 1110101 1011110100011
11111111 1111111 111111111111
