R 640 480
NO ../textures/wall_no.xpm
SO ../textures/wall_so.xpm
WE ../textures/wall_we.xpm
EA ../textures/wall_ea.xpm
S ../textures/barrel.xpm
F 255,195,0
C 225,30,0

111111111111111111111111111
100000000000000000000000001
101011111110011001101100W01
101012121210010011000110001
101000000000110110000011001
101111101111100100222001121
100000000000000000000000101
111111111102011100000000001
111111111111111111111111111